111111111111111111
100000000000000001
1C00P0000E00000001
111111111111111111