111111
100001
1C1111
100001
1P10E1
111111